NO textures/Diana_small.xpm
SO textures/Joan.xpm
EA textures/Bobby.xpm
WE textures/Hera.xpm

  
F 220,100,0
C 225,30,0 
	1111111111111111111111111111111111111111111
	1000000110000000000000001110000000000000001
	1001000000000000000001111111110000000110001
	1000000000010000000000000000000000000000001
	1000000000011110000001110000000001000001111
	10000E0000000001000000100000000001111000001
	1110000000000001100000111111111111111110001
	1000001100011000000000001000000000000000001
	10000001000000000000000010000000001111000011
	1001100000000011111000001000000000000111001
	1000000000110011000010000000111000000001111
	1111111111111111111111111111111111111111111