									NO 									textures/wall_1.xpm

F 220,100,0

		SO textures/wall_2.xpm






												EA 		textures/wall_3.xpm
								C 225,30,0




WE       textures/wall_4.xpm


1111111
1000001
1000001
1000001
1000W01
1000001
1111111