NO textures/Diana.xpm
SO textures/Diana.xpm
EA textures/Diana.xpm
WE textures/Diana.xpm
F 220,100,0
C 225,30,0


 11111111111111111111111111111111111111111111111111111111111111111111111111111111111111111111111111111111111111111
  1000000000000000000000000000000000000000000000000000000000000000000000000000000000000000000000000000000000000001
   100000000000000000000000000000000000000000000000000000000000000000000000000000000000000000000000000000000000001
    10000000000000000000000000000000000111111110000000000000000000000000000000000000000000000000000000000000000001
     10000000000000000000000000000000001      10000000000000000000000000000000000000000000000000000000000000000001
	  1000000000000000000000000000000001      10000000000000000000000000000000000000000000000000000000000000000001
       100000000000000000000000000000001      10000000000000000000000000000000000000000000000000000000000000000001
        10000000000000000000000000000001      10000000000000000000000000000000000000000000000000000000000000000001
         1000000000000000000000000000001      1000000000000000000000000000000000N0000000000000000000000000000000011111111111111111111
		  110000000000000000000000000001      100000000000000000000000000000000000000000000000000000000000000000000000000000000000001
		    1000000000000000000000000001      100000000000000000000000000000000000000000000000000000000000000000000000000000000000001
			 100000000000000000000000001      100000000000000000000000000000000000000000000000000000000000000000000000000000000000001
			  10000000000000000000000001      100000000000000000000000000000000000000000000000000000000000000000000000000000000000001
			   1000000000000000000000001111111100000000000000000000000000000000000000000000000000000000000000000000000000000000000001
				100000000000000000000000000000000000000000000000000000000000000000000000000000000000000000000000000000000000000000001
				 11111110000000000000000000000000000000000000000000001111111111111111111111111111111111111000000000000000000000000001
					   11111111100000000000000000000000000000000000001                                   1000000000000000000000000001
								10000000000000000000000000000000000001                                   1000000000000000000000000001
								10000000000000000000000000000000000001                                   1000000000000000000000000001
								10000000000000000000000000000000000001                                   1000000000000000000000000001
								10000000000000000000000000000000000001                                   1000000000000000000000000001
								10000000000000000000000000000000000001                                   1000000000000000000000000001
								10000000000000000000000000000000000001                                   1000000000000000000000000001
								10000000000000000000000000000000000001                                   1000000000000000000000000001
								10000000000000000000000000000000000001                                   1000000000000000000000000001
								10000000000000000000000000000000000001                                   1000000000000000000000000001
								10000000000000000000000000000000000001                                   1000000000000000000000000001
								10000000000000000000000000000000000001                                   1000000000000000000000000001
                                11111111111111111111111111111111111111                                   1111111111111111111111111111