NO textures/wall_1.xpm
SO textures/wood.xpm
EA textures/eagle.xpm
WE textures/purplestone.xpm

C 205,149,208
F 114,89,59

1111111111111111111111111111
1000000000000000000000000001
1001110011111111111111111101
1001000000000000000000000101
1001000111111111111111100101
1001000000100000000000100101
1001111000101111111110100101
1001000000100000000010100101
1001000111101000011110100101
10010000001010001E0010100001
1001111000101000011010100101
1001000000101111001000100101
1001000111101000001111100101
1001000000101111111111111101
1001111000100000000000000001
1000000000111111000111111001
1111111111111111111111111111