NO ./path_to_the_north_texture
SO ./path_to_the_south_texture

EA ./path_to_the_east_texture
WE ./path_to_the_west_texture
C 225,30,0
F 220,100,0

1111111111111111111111111111
1000000000000000000000000001
1001111111111111111111111101
1001                     101
1001      1111111111111  101
1001      1000000000001  101
1001      1011111111101  101
1001      101       101  101
1001      101    111101  101
1001      101   1N00101  101
1001      101    110101  101
1001      101     10001  10111
1001      101     11111  101
1001      101111111111111101
1001      100000000000000001
1001      111111111111111111
1111