NO textures/wall_1.xpm
SO textures/wall_2.xpm
hi
EA textures/wall_3.xpm
WE textures/wall_4.xpm
F 220,100,0
C 225,30,0

1111111111111111
1000000000010001
10000 0000011111
1000 N 000000001
11100 0000000001
1000000000011001
1000000000000001
1001100000000001
1000000000110001
1000000000100001
1001111000100001
1111111111111111