NO textures/wall_1.xpm
SO textures/wall_2.xpm
EA textures/wall_3.xpm
WE textures/wall_4.xpm
F 220,100,0
C 225,30,0

111111
1E0001
100001
100001
1000W1
111111
